<map>
00000000000000000004000000000400000000040000000004000000000400000000040000000004000000000400000000040000000400000004000000040000000400000004000000040000000400000004
00000000000000000001000000000100000000010000000001000000000100000000010000000001000000000100000000010000000100000001000000010000000100000001000000010000000100000001
00000000000000000101000000000100000000010000000001000000000100000000010000000001000000000100000000010000000100000001000000010000000100000001000000010000000100000101
00000000000000000000000000010100000000010000000001000000000100000000010000000001000000000100000000010000000100000001000000010000000100000001000000010000010100000000
00000000000000000001000000000000000001010000000001000000000100000000010000000001000000000100000000010000000100000001000000010000000100000001000001010000000000000011
00000000000000000001000000000100000000000000000101000000000100000000010000000001000000000100000000010000000100000001000000010000000100000101000000000000000100000001
00000000000000000001000000000100000000010000000000000000010100000000010000000001000000000100000002010000000100000001000000010000010100000000000000010000000100000001
00000000000000000001000000000100000000010000000001000000000000000001010000000001000000000100000000010000000100000001000001010000000000000001000000010000000100000001
00000000000000000001000000000100000000010000000001000000000100000000000000000101000000000100000000010000000100000101000000000000000100000001000000010000000100000001
00000000000000000001000000000100000000010000000001000000000100000000010000000000000000010100000000010000010100000000000000010000000100000001000000010000000100000001
00000000000000000001000000000100000000010000000001000000000100000000010000000001000000000000000001010000000000000001000000010000000100000001000000010000000100000001
00000000000000000001000000000100000000010000000001000000000100000000010000000001000000000100000000000000000100000001000000010000000100000001000000010000000100000001
00000000000000000001000000000100000000010000000001000000000100000000010000000001000000000100000000010000000100000001000000010000000100000001000000010000000100000001
00000000000000000006000000000600000000060000000006000000000600000000060000000006000000000600000000060000000600000006000000060000000600000006000000060000000600000006
</map>
<tip>
The key is under the rug, don't tell nobody.
</tip>