<map>
0000000000000000000000000000000000000000000000000000000000000000000000000000000000000000000000000000000000000000000000000000000000000000000000000000000000000000000000000100010001000100010001000100010001000100
0000000000000000000000000000000000000000000000040000000000000000000000000000000000000000000000000000000000000000000000000000000000000000000000000000000000000000000000000100010001000100000001000100010001000000
0000000000000000000000000000000000000000000100010000000000000000000000000000000000000009000000000000000000000000000000000000000000000100000001000000000000000000000000000100010001000000000000000100010001001100
0000000000000000000000000000000000000000000000010000000000000000000000000000000000000101010101010101000000000000000000000000000001010101010101010100000000000000000000000100010000000000000000000100010001000100
0000000000000000000000000000000000000000000010010000000000000000000000000000000000000100000000000001000000000000000000000000000001000600010006000100000000000000000000000100010001000000000000000000010000000100
0000000000000000000000000000000000000000010001000000000000000000000000000000000000000100000000000001000000000000000000000000000101050107010501070101000000000000000000000100010001000100000000000000010001000100
0000000000000000000000000000000000000000000001000000000000000000000000000001010100000100000000000001000000000000000000000000000001000400010004000100000000000000000000000100000001000100000000000000010001000100
0000000000000000000000000000000000000000001001000000000000000000000000000001000101010100000000000001000000000100000001000000000001010101010101010100000000000000000000000100010001000100010000000000000001000100
0000000000000000000000000000000000000001000100000000000000000000000000000001000000000000000000000001000000000101000101000000000001010101010101010100000000000000000000000100010001000100010000000000010001000100
0000000000000000000000000200000000000000000100000000000000000000010101000001000000000000000000000001000000000001080100000000000001080808010808080100000000000000000000000000010001000100010001000000010001000100
0000000000000000000000000000000000000000100100000000000000000000010001010101000000000000000000000001000000000001080100000000000001080108010801080100000000000101000000000100010001000100010001000000010001000100
0000000000000000000000000000000000000000010000000000000000000000010000000000000000000000000000000001000000000001080101010101010101080108010801080101010101010100000000000100010001000100010001000100010001000100
0000000000000000000000000000000000000000010000000000010101010000010000000000000000000000000000000001000000000001080808080808080808080108080801080808080808030000000000000100010001000100010001000100010001000100
0101010101010101010101010101010101010101010000000000000000010101010000000000000000000000000000000001010101010101010101010101010101010101010101010101010101010101010101010100010001000100010001000100010001000100
</map>
<tip>
01100010 01101111 01111000 01100101 01101100
</tip>