<map>
0000000000000000000000000000000000000000000000000000000000000000000000000000000000000000000000000000000000000000000000000000000000000000000000000000000000000000000000000000000000000000000000000000000000000000000000000000000000000000
0000000000000000000000000000000000010101010000000000000000000000000000000000000000000000000000000000000000000000000000000000000000000000000000000000000000000000000000000000000000000000000000000000000000000000000000000000000000000000
0000000000000000000000000000000000010000010101010000000000000000000000000000000000000000000000000000000000000000000000000000000000000000000000000000000000000000000000000000000000000000000000000000000000000000000000000000000000000000
0000000000000000000000000000010101010100010000010000000000000000000000000000000000000000000000000000000000000000000000000000000000000000000000000000000000000000000000000000000000000000000000000000000000000000000000000000000000000000
0000000000000000000000000000010000000101010000010000000000000000000000000000000000000000000000000000000000000000000000000000000000000000000000000000000000000000000000000000000000000000010101010000000001000000001111110000000000000000
0000000000000000000000000000010000000100010101010000000001010100000000000000000000000000000000000000000000000000000000000000000000000101010000000000000000000000000000000000000000000000010000010000000000000000001100110000000000000000
0000000000000000000101010000010000000100000000000000000001000100000000000000000000000000000000000000000000000000010101000000000000000100010000010101000000000000000000000000000000000101010000010000000000000000001111111111110000000000
0000000000010101010100010000010101010100000000000000000001010100000101010000000000000000000000000101010100000000010001000000000000000101010000010001000000000000000000000000000000000100010101010000000000000000000000110000110000000000
0000000000010000000101010000000000000000000000000101010000000000000100010000000000000000000000000100000100000000010101010101120000000000000000010101000000000000000000000000000000000101010000000000000000000000000000110000111111111111
0000000000010000000100000000000000000000000000000100010000000000000101010101010000000001010100000100000100000000000100000000010000000000000000000000000000000000000000000001010100000000000000000000000000000000000000111111110000000011
0000000000010000000100000000000000010101000000010101010000000000000000010000010000000001000100000101010100000000000100000000010101000000000000000000000000000000000000000001000100000000000000000000000000000000000000000000110000000011
0000000000010101010100000001010101010001010101010001000000000000000000010000010000000001010100000000000000000000000100000000010001000101010000000000000000000001010100000001010100000000000000000000000000000000000000000000110000000011
0000000000000000000000000001000100010101000100010101000000000000000000010101010000000000000000000000000000000000000100000000010101000100010000000000000000000001000100000000000000000000000000000000000000000000000000000000110000000011
0000000000000000000000000001010101010001010101010000000000000000000000000000000000000000000000000000000000000000000101010101010000000101010000000000000000000001010100000000000000000000000000000000000000000000000000000000111111111111
</map>
<tip>

</tip>