<map>
0000000000000000000000000000000000000000000000000000000000000000000000000000000000000000000000000000000000000000000000000000000000000000000000000000
0000000000000000000000000000000000000000000000010000000000000000000000000001000000000000000000000000000000000000000000010101000000000000000000000000
0000000000000000000000000000000000000000000000010000000000000000000000000001010000000000000000000000000000000000000000010001000000000000000000000000
0000000000000000000000000000000000000000000000010000000000000000000000000000010100000000000000000000000000000000000000010000000000000000010101010100
0000000000000000000000000000000000000000000001010100000000000000000000000100000101000000000000000000000000000000000101010001000000000000010000000100
0000000000000000000000000000000000000000000001000100000000000000000000000101000001010000000000000000000000000000000100010001000000000000000000000100
0000000000000000000000000000000000000000000001000100000000000000000000000001010000010100000000000000000000000000000100000001000000000000000000000100
0000000000000000000000000000000000000000000101000101000000000000000000010000010100000101000000000000000000000001010100010101000000000000000000000100
0000000000000000000000000000000000000000000100000001000000000000000000010100000101000001010000000000000000000001000100010000000000000000010000000100
0000000000000000000000000000020000000000000100000001000000000000000000000101000001010000010100000000000000000001000000010000000000000000011111110100
0000000000000000000000000000000000000000010100000001010000000000000001000001010000010100000101000000000000000001000101010000000000000000000000000000
0000000000000000000000000000000000000000010000000000010000000000000001010000010100000101000001010000000000000000000100000000000000000000000000000000
0000000000000000000000000000000000000000010000000000010000000000000001010100000000000000000000000000000000000000000100000000000000000000000000000000
0101010101010101010101010101010101010101010000000000010101010101010101010101010101010101010101010101010101010101010100000000000000000000000000000000
</map>
<tip>
Spam the jump button to prevent death. (PS, the whole screen is the jump button)
</tip>