<map>
0000000000000000000000000000000000000000000000000000000000000000000000000000000001010101010101010101010101010101010101010101010101010101010101000000000000000000000000000000000000000000000000000000000000000000000000000000000000000000000000000000
0000000000000000000000000000000000000000000000000000000000000000000000000000000001010101010101010101010101010101010101010101010101010101010101000000000000000000000000000000000000000000000000000000000000000000000000000000000000000000000000000000
0000000000000000000000000000000000000000000000000000000000000000000000000000000001010101010101010101010101010101010101010101010101010101010101000000000000000000000000000000000000000000000000000000000000000000000000000000000000000000000000000000
0000000000000000000000000000000000000000000000000000000000000000000000000000000001010101010101010101010101010101010101010100000000000000010101000000000000000000000000000000000000000000000000000000000000000000000000000000000000000000000000000000
0000000000000000000000000000000000000000000000000000000000000000000000000000000001010101010101000000000000000101010101010100000000000000010101000000000000000000000000000000000000000000000000000000000000000000000000000000000000000000000000000000
0000000000000000000000000000000000000000000000000000000000000000000000000000000001010101010101000000000000000101010101010100000001000000010101000000000000000000000000000000011111111111111101000000000000000000000000000000000000000000000000000000
0000000000000000000000000000000000000000000000000000000000000000000000000000000001010101010101000000010000000101010101010100000001000000010101000000000000000000000000000000000000000000000000000000000000000000000000000000000000000000000000000000
0000000000000000000000000000000000000000000000000000000000000000000000000000000000000008000000000000010000000000000900000000000001000000000000000000000000000000000000000000000000000000000000000000000000000000000000000000000000000000000000000000
0000000000000000000000000000000000000000000000000000000000000000000000000000000000000008000000000000010000000000000900000000000001000000000000000000000000000800000000000000000000000000000000000000000000000000000000000000000000000000000000000000
0000000000000000000000000200000000000000090000000000000001010101010000000000000001010101010101010101010101010101010101010101010101010101010101010101011201010101010101120101010101010101010101010101010100000001010100000001010100000001111111111111
0000000000000000000000000000000000000000010000000000000001000000010000000000000001010101010101010101010101010101010101010101010101010101010101000000000000000000000000000000000000000000000000000000000104040401000104040401000104040401000000000000
0000000000000000000000000000000000000000010000000000000001000000010000000000000001010101010101010101010101010101010101010101010101010101010101000000000000000000000000000000000000000000000000000000000101010101000101010101000101010101000000000000
0000000000000000000000000000000000000000010000000000000001000000010000000000000001010101010101010101010101010101010101010101010101010101010101000000000000000000000000000000000000000000000000000000000000000000000000000000000000000000000000000000
0101010101010101010101010101010101010101010101010101010101000000010101010112010101010101010101010101010101010101010101010101010101010101010101000000000000000000000000000000000000000000000000000000000000000000000000000000000000000000000000000000
</map>
<tip>
The smaller you are, the higher you jump!
</tip>