<map>
000000000000000000000000000000000000000000000000000000000000000000000000000000000000000000000000000000000000000000000000000000000000000000000000000000000000000000000000000000000000
000000000000000000000000000000000101010101010101010101010101010101010101010101010101010101010101010101010101010101010101010101010101000000010101000000010101000000010101000000010101
000000000000000000000000000000000000000000000000000000000000000000010000000000000000010000000000000000000000000000000000000000000000000000000000000000000000000000000000000000000000
000000000000000000000000000000000000000000000000000000000000000000010000000000000000010000000000000000000000000000000000000000000000000000000000000000000000000000000000000000000000
000000000000000000000000000000000101010101010000000000000101010101010000000101010101010101010101010101010101010101010101010101010101000000010101000000010101000000010101000000111111
000000000000000000000000000000000000000000010000000000000000000000010000000000000000000000000000000000000000010000000000010000000000000000000000000000000000000000000000000000000000
000000000000000000000000000000000000000000010000000000000000000000010000000000000000000000000000000000000000010000000000010000000000000000000000000000000000000000000000000000000000
010101010101010101010101000000000101010101010000000000000101010101010000000101010101010101010101010100000001010101010101010101010101000000010101000000010101000000010101000000010101
000000000000000000000001000000000000000000010000000000000000000000000000000000000000000000000000010000000000000000000000000000000000000000000000000000000000000000000000000000000000
000000000000000000000001000000000000000000010000000000000000000000000000000000000000000000000000010000000000000000000000000000000000000000000000000000000000000000000000000000000000
000000000000000000000001000000000101010101010000000000000101010101010000000101010101010101010101010101010101010101010101010101010101000000010101000000010101000000010101000000010101
000000000000000000000001000000000000000000010000000000000000000000010000000000000000010000000000000000000000000000000000010000000000000000000000000000000000000000000000000000000000
000000000000000000000001000000000000000000010000000000000000000000010000000000000000010000000000000000000000000000000000010000000000000000000000000000000000000000000000000000000000
000000000000000000000001010101010101010101010000000000000101010101010000000101010101010101010101010101010101010101010101010101010101000000010101000000010101000000010101000000010101
</map>
<tip>

</tip>