<map>
000000000000000000000000000002000000000000000000000000000000000000000000000000000000000000000000000000000000000000000000000000000000000000000000000000000000000000000000000000000000000000000000000000000000000000000000000000000000000000000000000000040400000000000000000000000000000000000000000000000000
000000000000000000000000000000000000000000000000000000000000000000000000000000000000000000000000000000000000000000000000000000000000000000000000000000000000000101010101000000000101010101010100000000000000000000000000000000000000000000000000000007010105000000000000000004040000000000000000000000000000
000000000000000000000000000000000000000000000000000000000000000000000000000000000000000000000000000000000101010101000000000000000000000000000000000000000000000100060001000000000100000600000100000000000000000000000000000000000000000000000000000007010105000000000000000701010500000000000000000000000000
010101010101010101010101010101010101010000000001010101010000000000000000000000000000000000000000000000000100060001000000000000000000000000000000010101010100000000000000000000000000000000000000000000000000000000000000000000000000000000000000000000060600000000000000000701010500000000000000000000000000
000000000000000000000000000001000600010000000001000600010000000000000000000000000101120110010101010000000000000001000000000000000000000000000000010006000100000000000000000000000000000000000000000000000000000000000000000000000000000000000000000000000000000000000000000006060000000000000000000101010101
000000000000000000000000000001000000000000000000000000000000000000000000000000000100000006000000010000000000000001000000000000000001010101010000000000000000000000000000000000000000000000000000010111111111111111111111111111111101010000000000000000000000000000000000000000000000000000000000000100060001
000000000000000000000000000001000000000000000000000000000000000101010101010100000000000000000000000000000000000001000000000000000001000600010000000000000000000000000000000000000000000000000000000101010101010101010101010101010101000000000000000000000000000000000000000000000000000000000000000100000000
000000000000000000000000000001000000000000000000000000000000000100000600000100000000000000000000000000000000000001010101010101000000000000000000000000000000000000000000000000010110010100000000000001010100010001000100010001010100000000000000000000000000000000000004040000000000000000000000000100000000
000000000000000000000000000001000000000000000000000000000000000000000000000000000000000000000000000000000000000001000006000001000000000000000000000000000000000000000000000000010006000100000000000000010101010101010101010101010000000000000000000000000000000000000701010500000000000000000000000100000000
000000000000000000000000000001000000000000000000000000000000000000000000000000000000000000000000000000000000000000000000000000000000000000000000000000000000000000000000000000000000000000000000000000000101010101010101010101000000000000000000000000000000000000000701010500000000000000000000000100000000
000000000000000000000000000001000000000000000000000000000000000000000000000000000000000000000000000000000000000000000000000000000000000000000000000000000000000000000000000000000000000000000000000000000001010101010101010100000000000000000000000000000000000000000006060000000000000000000000000100000000
000000000000000000000000000001000000000000000000000000000000000000000000000000000000000000000000000000000000000000000000000000000000000000000000000000000000000000000000000000000000000000000000000000000000000000000000000000000000000000000000000000000000000000000000000000000000000000000000000100000000
000000000000000000000000000001101010101010101010101010101010101010101010101010101010101010101010101010101010101010101010101010101010101010101010101010101010101010101010101010101010101010101010101010101010101010101010101010101010101010101010101010101010101010101010101010101010101010101010100100000000
000000000000000000000000000001010101010101010101010101010101010101010101010101010101010101010101010101010101010101010101010101010101010101010101010101010101010101010101010101010101010101010101010101010101010101010101010101010101010101010101010101010101010101010101010101010101010101010101010100000000
</map>
<tip>
Don't fall in the bounce pit
</tip>