<map>
0000000000000000000000000000000000000000000000000000000000000000000000000000000000000400000701000000000000000000000000000000010101000000000000000000000000000000000000000000000000000000000000000000000000000000000000000000000000000000000000000000000000000000000000000000000000000000000000000000000000000000000000000000000000000000000000000000000000000000000000000000000000000000000000000000000000000000040000000000000000000000000000000000000000000000000000000000000000000000
0000000000000000000000000000000000000000000000000701000000000000000000000000000000000100000701000000000000000000000000000000010101000000000000000000000000010000000000000000000000000000000000000000000000000000000000000000000000000000000000000000000000000000000000000000000000000000000000000000000000000000000000000000000000000000000000000000000000000000000000000000000000000000000000000000000004000100010001000400000000000000000000000000000000000000000000000000011111110100
0000000000000000000000000000000000000000000000000701000000000000000000000100000000000000000701000000000000000000000000000000010101000000000000000000000000010000000000000000000000000000000000000000000000000000000000080300000000000000000000000000000000000000000000000000000000000000000000000000000000000000000000000000000000000000000000000000000000000000000000000000000000000000000000000400010001000000000000000100010004000000000000000000000000000000000000000000011111110100
0000000000000000000000000000000000000000000000000701000000000000000000000000000000000000000701000000000000000001010000000000010101000000000000000000000000010001000000000000000100000000000100000000000100000000000101010101010000000000000000000000000000000000000000000000000000000000000000000000000000000000000000000000000000000000000000000000000000000000000000000000000000000000040001000100000000000000000000000000000001000100040000000000000000000000000000000000011111110100
0000000000000000000000000000000000000000000000000701000000000000000000000007010000000000000000000000000000000001010000000000010101000000000000000100000000010001000000000000000100000000000000000000000000000000000101010101010000000000000000000000000004000000000000040000000000000400000000000000000014000000000000000000000000000000000000000000000000000000000000000000000004000100010000000000000000000000000000000000000000000000010001000400000000000000000000000000011111110100
0000000000000000000000000001000000000000010000000701000000000000010000000007010000000000000000000000010100000001010000000000010101000000000000000100000000010001000100000000000100000000000000000000000000000000000101010101010000000000000000000000000001000000000000010000000000000100000000000000000000000000000000000000000000000000000000000000000000000000000000000400010001000000000000000000000000000000000000000000000000000000000000000100010004000000000000000000011111110100
0000000000000000000000000000000404040400000000000000000000000000000000000007010000000000000000000000010100000001010000000000010101000000000000000100000000010001000100000000000100000000000000000000000000000000000101010101010000000000000000000000000001000000000000010000000000000100000000000000000000000000000000000000000000000000000000000000000000000000040001000100000000000000000000000000000000000000000000000000000000000000000000000000000001000100040010000000011111110100
0000000000000000000000000000000101010100000000000000000000000000000000000007010000040404000000000000010100000001010000000000000900000000000000000100000000010001000100010000000100000000040404000000040404000000000101010101010000000000000000000100000001000001000000010000010000000100000300000000000000000000040000000400000004000000040000000400000004000100010000000000000000000000000000000000000000000000000000000000000000000000000000000000000000000000010001000000011111110100
0101010101010101010101010101010101010101010101010101010101010101010101010101010101010101010101010101010101010101010101010101010101010101010101010101010101010101010101010101010101010101010101010101010101010101010101010101010101010101010101010101010101010101010101010101010101010101010101010101010101010101010101010101010101010101010101010101010101000000000000000000000000000000000000000000000000000000000000000000000000000000000000000000000000000000000000000000010101010100
0000000000000000000000000000000000000000000000000000000000000000000000000000000000000000000000000000000000000000000000000000000000000000000000000000000000000000000000000000000000000000000000000000000000000000000000000000000000000000000000000000000000000000000000000000000000000000000000000000000000000000000000000000000000000000000000000000000000000000000000000000000000000000000000000000000000000000000000000000000000000000000000000000000000000000000000000000000000000000
0000000000000000000000000000000000000000000000000000000000000000000000000000000000000000000000000000000000000000000000000000000000000000000000000000000000000000000000000000000000000000000000000000000000000000000000000000000000000000000000000000000000000000000000000000000000000000000000000000000000000000000000000000000000000000000000000000000000000000000000000000000000000000000000000000000000000000000000000000000000000000000000000000000000000000000000000000000000000000
0000000000000000000000000000000000000000000000000000000000000000000000000000000000000000000000000000000000000000000000000000000000000000000000000000000000000000000000000000000000000000000000000000000000000000000000000000000000000000000000000000000000000000000000000000000000000000000000000000000000000000000000000000000000000000000000000000000000000000000000000000000000000000000000000000000000000000000000000000000000000000000000000000000000000000000000000000000000000000
0000000000000000000000000000000000000000000000000000000000000000000000000000000000000000000000000000000000000000000000000000000000000000000000000000000000000000000000000000000000000000000000000000000000000000000000000000000000000000000000000000000000000000000000000000000000000000000000000000000000000000000000000000000000000000000000000000000000000000000000000000000000000000000000000000000000000000000000000000000000000000000000000000000000000000000000000000000000000000
0000000000000000000000000000000000000000000000000000000000000000000000000000000000000000000000000000000000000000000000000000000000000000000000000000000000000000000000000000000000000000000000000000000000000000000000000000000000000000000000000000000000000000000000000000000000000000000000000000000000000000000000000000000000000000000000000000000000000000000000000000000000000000000000000000000000000000000000000000000000000000000000000000000000000000000000000000000000000000
</map>
<tip>

</tip>