<map>
0000000000000000000000000000000000000000000000000000000000000001000000000000000000000000000000000000000000000000000000000000000000000000000000000000000000000000
0000000000000000000000000000000000000000000000000000000000000001000000000000000000000000000000000000000000000000000000000000000000000000000000000000000000000000
0000000000000000000000000000000000000000000000000000000000000001000600000000000000000000000000000000000000000000000000000000000000000000000000000000000000000000
0000000000000000000000000000000000000000000000000000001200000001000000000000000000000000000000000000000000000000000000000000000000000000000000000000000000000000
0000000000000000000000000000000000000000000000000000000104040401000000060000000000000000000000000000000000000000000000000000000000000000000000000000000000000000
0000000000000000000000000002000000000000000000000000000101010101000400000000000000000000000000000000000000000000000000000000000000000000000000000000000000000000
0000000000000000000000000000000000000000000000120000000100000001000100000006000000000000000000000000000000000000000000000000000000000000000000000000000000000000
0000000000000000000000000000000000000000000000010000000100000001000100040000000000000000000000000000000000000000000000000000000000000000000000000000000000000000
0000000000000000000000000000000000000000000000010101100100000001000100010000000600000000000000000000000000000000000000000000000000000000000000040000000000000000
0606010106060101060601010606010106060112000000010000000100000001000100010004000000000000000100000000000000040000000000000000040000000000000000011111111111111111
0000000000000000000000000000000000000001000000010000000100000001000100010001000000010101010101010101120101010101010101120101010101010101120101010000000000000000
0000000000000000000000000000000000000001010110010000000100000001000100010001000400010000000100000000000000000000000000000000000000000000000000000000000000000000
0000000000000000000000000000000000000001000000010000000100000001000100010001000100010000000100000000000000000000000000000000000000000000000000000000000000000000
0000000000000000000000000000000000000006000000060000000600000006000600060006000600060000000600000000000000000000000000000000000000000000000000000000000000000000
</map>
<tip>
Not all spikes are jerks, but some of them are.
</tip>