<map>
0000000000000000000000000000000000000909000009090909090000000000000000000000000000000000000000000000000000000000000000000000000000000000000000000000000000000000000000000000000000000000000000000000000000000000000009090000000000000000000000000000000000000100000000000000000000000000000909090900000000000000000000000000000000000000000000000000000000000000000000000000000000
0000000000000009090009090900000000000909090909090909090909000000000000000000000000000000000000000000000000000000000000000000000000000000000000000000010000000000000000000000000000000000000000000000000000000014001409090909000000000000000000000000000000000100000000000000000000000900090909090000000000000000090900090909090900000000090000000000000000000000000000000000000000
0000000000000009090909090900000909000009090909090809090909090000000009090900000909000000000000000000000000000000000000000000000000000000000000000000000000000000000000000000000000000000000000000000000000000001000109090909000000000000000000000000000000000100000000000000000000090909090909090000000000000009090900000909090909000000090900000000000000000000000000000000000000
0000000000000000090909090909090909000000090909090808080909090000000009090900090909000000000000000000000000000000000000000000000000000000000000000000000000000909000000000000000000000000000000000000000000000001000109090909000000000000000000000000000909090100000000000000000000000009000000090000000000000909090000000009090909000000090909000000000000000000000000000000000000
0000000000000009090909080909090000000000090908080809090909000000000909090909090909000000000000000000000000000000000000000000000000000000000000000000000000090909000000000000000000000000000000000000000000000001000109090000000000000000000000000009090909090100000000000000000000000909000000000000000000000909090909090909090000000000090900000000000000000000000000000000000000
0000000000000009090808080808090000000000090909090809090900000000090909090909090000000000000000000000000000000000000000000000000000000000000001000000090909090909000000000000000100000000000000000000000109090901000100000000000909090909000000000009090909090100000000000000000000000909090909090000000000000009090909090900000000000000090900000000000000000000000000000000000000
0000000000000009090909080909090000000000000909090809090909000000090909090909090900000000000000000000000000000000000000000000000000000000000000000000090909090909090909000000000000000000000000000000000909090901000100000000090909090909090000000909090909090100000000000000000000000900090909090000000000000000000000000000000000000000000000000000000000000000000000000000000000
0000000000000909090909080909090000000000000909000809090909090000000009090809090900000000000000000000000000000000000000000000000000000000000000000000090909090909090909000000090909090000000000000000000909090901000100000001010101010101010101010101010101010100000009090900000000000000090909000000000000000000000000000000090909090000000000000000000000000000000000000000000000
0000000000000909000909080909000000000000000000000800000009090000000909090809090909000000000000000000000000000000000000000000000000000000000009090900000009090909090909090909090909090900000000000000090909090901000100000001000000000000000000000000000000000100000909090909000000000000000000000000000000090900000000000909090909090000000000090909090000000000000000000000000000
0000000000000000000000080900000000000200000000000800000000000000090909000800000909000000000000000100000000000000000000000000000000000100000909090900000909090009000009010909090909090000000000010000000900090901000100000001000800000000000008000000000008000100000909010909000000010000000000010000000909010900000000010009090909010000000009090909000000000000000000001100000000
0000000000000000000000080000000000000000000000000800000000000000000909000800000000000000000000000100000000000000000000000000000000000000000909090000000909090000000909090900000009000000000909090000000000000001000100000001000000000000000000000000000000000100000909090909000000000000000000000909090909000000000000000000090909000000000909090909090909090900000000000100000000
0000000000000000000000080000000000000000000000000800000000000000000000000800000000000000000000000100000000000000000000000000000000000000000009090000000000000000090909090900000000000000000909090900000000000001000101010101000000000000000000000000000000000100000009090900000000000000000000000000090909090000000000000000000000000000000000090909090909090000000000000100000000
0000000000000000000000080000000000000000000000000800000000000000000000000800000000000000000000000100000000000300000000000000000000000909090000000000000000000000090909090000000000000000090909090900000000000001000000000000000000000800000000000008000000000000000000000000000000000000000000000000000000000000000000000000000000000000000000000000000000000000000000000100000000
0101010101010101010101010101010101010101010101010101010101010101010101010101010101010101010101010101010101010101010101010101010000090909090000000000000000000001090909090000000000000001000909090000000000000001010101010101010101010101010101010101010101010100000000000000000000000000000000000000000000000000000000000000000000000000010000000000010000000000010000000100000000
</map>
<tip>
Touch the cherry blossom!
</tip>