<map>
000000000000000000000000000000000000000000000000000000000000000000000000000000000000000000000000000000000000000000000000000000000000000000000001010101010000000000000000000000000000000000000000000000000000010000000000000000000000000001010101010101010000000000000000000000000000000000000000000000000000000000000000000000000000000000000000000000000000000000000000000000000000
000000000000000000000000000000000000000000000000000000000000000000000000000000000000000000000000000000000000000000000000000000000000000000000006060106060000000000000100000000000000000000000000000000000000010000000000000000000000000009000909090909010000000000000000000000000000000000000000000000000000000101010101010101010000000000000000000000000000000000000000000000000000
000000000000000000000000000000000000000000000000000000000000000000000000000000000000000000000000000000000000000000000000010100000000000000000000000100000000000000000100000000000000000000000000000001000000010000000000000000000000000000000009000909010000000000000000000000000000000000000000000000000000000100090900090000010000000000000000000000000000000000000000000000000000
000000000000000000000000000000000000000000000000000000000000000000000000000000000000000001010000000000000000000000000000010100000000000000000000000000000000000000000100000000000000000000000000000001000000010000000000000000000000000000000000000009010000000000000000000000000000000000000000000000000000000109090000000900010000000000000000000000000000000000000000000000000000
000000000000000000000000000000000000000000000000000000000000000000000000000000000000000001010000000000000000000000000000010100000000000000000000000000000000000000000100000000000000000000000000000001000000010000000000000000000000000000000909000000010000000000000000000000000000000000000000000000000000000109000000000909010000000000000000000000000000000000000000000000000000
000000000000000000000000010000000000000000000001000000000000000000000000000000000000000001010000000000000000000000000000010100000000000000000000000100000000000000000100000000000000000000000100000001000000010000000000000000000000000001010101010109010000000000000000000000000000000000000000000000000000000100000000000000010000000000000000000000000000000000000000040004000000
000000000000000000000000010000000000000000000001000000000000000000000000000000000000010101010101000000000000000000000101010101010000000000000000000100000000000000000100000000000000000000000100000001000000010000000000000000000000000001000000000109010101010101000000000001010101010101010100000000000000000100090900090900010000000000000000000000000000000000000000010901000000
000000000000000000000001010100040404000000000101010004040400000000000000000000001000010101010101000000000000000010000101010101010000000000000004040104040000000000100101000000000000000000010101000101010001010100000000000000000000000001000000000109090909090901000000000001090909090009000100000000000000000109090000000909010000000000000000010901000000000101000000010901000000
010101010101010101010101010101010101010101010101010101010101010101010101010101010101010101010101010101010101010101010101010101010101010101010101010101010101010101010101010101010101010101010101010101010101010101000000000000000000000001000000000101010101010901000000000001090900000009090100000000000000000109000000000900010000000000000000010901000000000101000000010901000000
000000000000000000000000000000000000000000000000000000000000000000000000000000000000000000000000000000000000000000000000000000000000000000000000000000000000000000000000000000000000000000000000000000000000000001000000000000000000000001000000000000000000010901000000000001090000090000090100000000000000000100000900000000010101000000000000010901000000000000000000010901000000
000000000000000000000000000000000000000000000000000000000000000000000000000000000000000000000000000000000000000000000000000000000000000000000000000000000000000000000000000000000000000000000000000000000000000001000000000003000000000001000000000000000000010901000000000001090000000000000100000000000000000100000000000000090901000000000000010901000000000000000000010901000000
000000000000000000000000000000000000000000000000000000000000000000000000000000000000000000000000000000000000000000000000000000000000000000000000000000000000000000000000000000000000000000000000000000000000000001010101010101010101011001000000000000000000010901010101010101000000000900000101010101010101010100000000000101010901010101010101010901000000000000000000010901000000
000000000000000000000000000000000000000000000000000000000000000000000000000000000000000000000000000000000000000000000000000000000000000000000000000000000000000000000000000000000000000000000000000000000000000000000000000000000000000000000000000000000000010909090909090909000000000000000909090909090909090900000900000000010909090909090909090901000000000000000101010901010100
000000000000000000000000000000000000000000000000000000000000000000000000000000000000000000000000000000000000000000000000000000000000000000000000000000000000000000000000000000000000000000000000000000000000000000000000000000000000000000000000000000000000010101010101010101010009000000010101010101010101010100000000090000010101010101010101011001000000000000000101011101010100
</map>
<tip>

</tip>