<map>
00000000000000000000000000000000000000000000000000000000000000000000000000000000000000000000000000000000000000000000000000000000000000000000000000000000000000000000000000000000000000000000000000000000000000000000000000000000000000000000000000000000000000000000
00000000000000000000000000000000000000000000000000000000000000000000000000000000000200000000000000000000000000000000000000000000000000000000000000000000000000000000000000000000000000000000000000000000000000000000000000000000000000000000000000000000000000000000
00000000000000000000000000000000000000000000000000000000000000000000000000000000000000000000000000000000000000000000000000000000000000000000000000000000000000000000000000000000000000000000000000000000000000000000000000000000000000000000000000000101010101010101
00000000000000000000000000000000000000000000000000000000000000000000000000000000000000000000000000000000000000000000000000000000000000000000000000000000000000000000000000000000000000000000000000000000000000000000000000000000000000000000000000000100000000000001
00000000000000000000000000000000000000000000000000000000000000000000000000000000000000000000000000000000000000000000000000000000000000000000000000000000000000000000000000000000000000000000000000000000000000000000000000000000000000000000000000000100000000000001
01010101010101010100000000000100000000000100000000000100000000000100000000000101010101010100000000000100000000000101010000000000010101000000000001010100000000000101010000000000060000000000060000000000060000000000100000000000000006000000000000000100000000000001
00000000000000000100000000000000000000000000000000000000000000000000000000000100000000000100000000000000000000000100010000000000010001000000000001000100000000000100010000000000000000000000000000000000000000000000000000000000000000000000000000000600000000000001
00000000000000000100000000000000000000000000000000000000000000000000000000000101010101010100000000000000000000000101010000000000010101000000000001010100000000000101010000000000000000000000000000000000000000000000000000000000000000000000000000000000000000111101
00000000000000000100000000000000000000000000000000000000000000000000000000000000000000000000000000000000000000000000000000000000000000000000000000000000000000000000000000000000000000000000000000000000000000000000000000000000000000000000000000000000000000000000
00000000000000000100000000000000000000000000000000000000000000000000000000000000000000000000000000000000000000000000000000000000000000000000000000000000000000000000000000000000000000000000000000000000000000000000000000000000000000000000000000000000000000000000
00000000000000000100000000000000000000000000000000000000000000000000000000000101010101010100000000000000000000000000000000000000000000000000000000000000000000000000000000000000000000000000000000000000000000000000000000000000000000000000000000000000000000000000
00000000000000000100000000000000000000000000000000000000000000000000000000000100000000000100000000000000000000000000000000000000000000000004000000000000000000000000000000000000000000000000000000000000000000000000000000000000000004000000000000000000100000000000
00000000000000000100000000000000000000000000000000000000000000000000000000000100000000000100000000000000000400000000000000040000000000000001000000000000000400000000000000000000040000000000040000000000040000000000040000000000000001000000000000000400010000000000
00000000000000000101010101010101011001010101011001010101011001010101010101010100000000000101010101010101010101010101010101010101010101010101010101010101010101010101010101010101010101010101010101010101010101010101010101010101010101010101010101010100010000000000
</map>
<tip>
Congratulations! You win absolutely nothing!
</tip>